world builder = світобудівництво
tile = плитка
Appeal = Привабливість
Adjacency = суміжність
bonus = бонус (плюсик)
Faith, Gold, Science, Culture, Diplomacy = віра, золото (гривні), наука, культура, дипломатія
goody huts = хуторці 

Production = Продукція (виробництво)
Great Works = видатні праці
Minor civ = Мала цивілізація

City centre = центр міста
Commercial Hub = комерційний центр
Harbor = гавань
Shipyard – Корабельня
Royal Navy Dockyard = корабельня королівського військово-морського флоту
Mine = Шахта (-копальня)
Quarry = Кар'єр
farm = ферма (хутір, господарство)
plantation = плантація
pasture = пасовище
Camp = табір
Antiquity Sites = пам'ятки Античності

Hills - пагорби
rainforest = тропічний ліс
Tundra = тундра
desert = пустеля
Floodplains = заплави

Scout = Блукач
Builder = Мастак
anvoy = посланець